 __________________
|  | |         |   |
|  | |___      |   |
|  |               |
|             _____|
|             _____|
|                  |
|           __     |
| |           |  | |
|_|___________|__|_|
360
